▤▤▤▤▤▤▤▤▤▤▤▤▤▤▤▤▤▤▤▤▤▤▤▤▤▤▤▤▤▤▤▤▤▤▤▤▤▤▤▤▤▤▤▤▤▤▤▤▤▤▤▤▤▤▤▤▤▤▤▤▤▤▤▤▤▤▤▤▤▤▤▤▤▤▤▤▤▤▤▤
▤♣♣♣♣♣♣♣♣♣♣♣♣♣♣▤             ▤                            ▤                    ▤
▤♣♣♣▤▤▤▤  ☺                  ▤        ♣♣♣♣                ▤                    ▤
▤♣♣♣▤▤▤▤                                                 ▤▤▤▤▤▤▤▤▤▤▤▤▤▤▤▤▤▤▤▤▤▤▤
▤                                          ♣      ♣♣♣♣    ▤                    ▤
▤♣♣♣                         ▤             ♣♣♣♣                                ▤
▤♣♣♣♣    ▤▤▤▤▤▤▤▤            ▤          ♣♣♣♣  ♣♣♣♣        ▤                    ▤
▤ ♣♣♣♣   ▤♣♣♣♣  ▤            ▤                            ▤                    ▤
▤  ♣     ▤♣♣♣♣  ▤            ▤         ▤▤▤▤▤▤▤▤▤▤▤▤▤▤▤▤▤▤▤▤     ♣♣♣♣♣♣♣♣♣♣♣♣♣♣♣▤
▤        ▤♣♣♣♣  ▤▤▤▤▤▤▤▤▤▤▤  ▤                            ▤       ♣♣♣♣♣♣♣♣♣♣♣♣♣▤
▤    ♣   ▤♣♣♣♣               ▤           ♣♣♣♣             ▤♣♣♣♣♣♣♣♣♣♣♣♣♣       ▤
▤        ▤Ψ                  ▤                            ▤♣♣♣♣♣♣♣♣♣♣♣♣♣       ▤
▤        ▤▤▤▤▤▤▤▤▤▤▤▤▤▤▤▤▤▤▤▤▤▤▤▤▤▤▤▤▤▤▤▤▤▤▤▤▤▤▤▤▤▤▤▤▤    ▤                    ▤
▤                            ▤       ♣♣♣♣♣♣♣♣♣♣♣          ▤                    ▤
▤                  ♣♣♣       ▤       ♣♣♣♣♣♣♣♣♣♣♣          ▤ ♣♣♣♣♣♣♣♣♣♣♣♣♣      ▤
▤                   ♣        ▤       ♣♣♣♣♣♣♣♣♣♣♣          ▤                    ▤
▤  ▤▤▤▤▤▤▤▤▤▤▤▤▤▤▤▤▤▤▤▤▤▤▤   ▤                            ▤                    ▤
▤  ▤        ♣♣♣♣♣♣♣♣     ▤♣♣ ▤                            ▤                    ▤
▤  ▤        ♣♣♣♣♣♣♣♣     ▤♣♣ ▤      ♣♣♣♣♣♣♣♣♣♣♣           ▤                    ▤
▤  ▤        ♣♣♣♣         ▤♣♣ ▤      ♣♣♣♣♣♣♣♣♣♣♣           ▤▤▤▤▤▤▤▤▤▤▤▤▤▤▤▤▤▤▤▤ ▤
▤  ▤                     ▤▤▤▤▤                            ▤       ♣♣♣♣♣♣♣♣♣♣♣♣♣▤
▤  ▤                         ▤                            ▤      ♣♣♣♣♣♣♣♣♣♣♣♣♣♣▤
▤  ▤                                                           ♣♣♣♣♣♣♣♣♣♣♣♣♣♣♣♣▤
▤  ▤  ▤▤▤▤▤▤▤▤▤▤▤▤▤▤▤▤▤▤▤▤▤▤▤▤            ♣♣♣♣♣♣          ▤   ♣♣♣♣♣♣♣♣♣♣♣♣♣♣♣♣♣▤
▤  ▤  ♣♣♣♣      ♣♣♣♣         ▤             ♣♣♣♣           ▤ ♣♣♣♣♣♣♣♣♣♣♣♣♣♣♣♣♣♣♣▤
▤  ▤            ♣♣♣♣         ▤           ♣♣♣♣             ▤ ♣♣♣♣♣♣♣♣♣♣♣♣♣♣♣♣♣♣♣▤
▤  ▤            ♣♣♣♣         ▤           ♣♣♣♣             ▤ ♣♣♣♣♣♣♣♣♣♣♣♣♣♣♣♣♣♣♣▤
▤  ▤            ♣♣♣♣         ▤           ♣♣♣♣             ▤ ♣♣♣♣♣♣♣♣♣♣♣♣♣♣♣♣♣♣♣▤
▤                            ▤                            ▤Ψ♣♣♣♣♣♣♣♣♣♣♣♣♣♣♣♣♣♣♣▤
▤▤▤▤▤▤▤▤▤▤▤▤▤▤▤▤▤▤▤▤▤▤▤▤▤▤▤▤▤▤▤▤▤▤▤▤▤▤▤▤▤▤▤▤▤▤▤▤▤▤▤▤▤▤▤▤▤▤▤▤▤▤▤▤▤▤▤▤▤▤▤▤▤▤▤▤▤▤▤▤